16 16 16 16 16 16 16 16 16 16 16 16 16 16 16 16 16 16 16 16 16 16 16 16 16 16 16 16 16 16 16 16 16 16 16 16 16 16 16 16 16 16 16 16 16 16 16 16 16 16 16 16
16 2 10 10 10 10 10 10 10 10 10 6 10 10 10 10 10 10 10 10 10 6 10 10 10 10 10 10 10 10 10 6 10 10 10 10 10 10 10 10 10 6 10 10 10 10 10 10 10 10 3 16
16 11 16 16 16 16 16 16 16 16 16 11 16 16 16 16 16 16 16 16 16 11 16 16 16 16 16 16 16 16 16 11 16 16 16 16 16 16 16 16 16 11 16 16 16 16 16 16 16 16 11 16
16 11 16 16 16 16 16 16 16 16 16 11 16 16 16 16 16 16 16 16 16 11 16 16 16 16 16 16 16 16 16 11 16 16 16 16 16 16 16 16 16 11 16 16 16 16 16 16 16 16 11 16
16 11 16 16 16 16 16 16 16 16 16 15 16 16 16 16 16 16 16 16 16 15 16 16 16 16 16 16 16 16 16 15 16 16 16 16 16 16 16 16 16 15 16 16 16 16 16 16 16 16 11 16
16 7 10 10 10 12 13 10 10 10 10 9 10 10 12 13 10 10 10 10 10 9 10 10 12 13 10 10 10 10 10 9 10 10 12 13 10 10 10 10 10 9 10 10 12 13 10 10 10 10 8 16
16 11 16 16 16 11 11 16 16 16 16 11 16 16 11 11 16 16 16 16 16 11 16 16 11 11 16 16 16 16 16 11 16 16 11 11 16 16 16 16 16 11 16 16 11 11 16 16 16 16 11 16
16 11 16 16 16 14 14 16 16 16 16 11 16 16 14 14 16 16 16 16 16 11 16 16 14 14 16 16 16 16 16 11 16 16 14 14 16 16 16 16 16 11 16 16 14 14 16 16 16 16 11 16
16 11 16 16 16 16 16 16 16 16 16 11 16 16 16 16 16 16 16 16 16 11 16 16 16 16 16 16 16 16 16 11 16 16 16 16 16 16 16 16 16 11 16 16 16 16 16 16 16 16 11 16
16 7 10 10 10 10 10 10 10 10 10 9 10 10 10 10 10 10 10 10 10 9 10 10 10 10 10 10 10 10 10 9 10 10 10 10 10 10 10 10 10 9 10 10 10 10 10 10 10 10 8 16
16 11 16 16 16 16 16 16 16 16 16 11 16 16 16 16 16 16 16 16 16 11 16 16 16 16 16 16 16 16 16 11 16 16 16 16 16 16 16 16 16 11 16 16 16 16 16 16 16 16 11 16
16 11 16 16 16 16 16 16 16 16 16 11 16 16 16 16 16 16 16 16 16 11 16 16 16 16 16 16 16 16 16 11 16 16 16 16 16 16 16 16 16 11 16 16 16 16 16 16 16 16 11 16
16 11 16 16 16 16 16 16 16 16 16 15 16 16 16 16 16 16 16 16 16 15 16 16 16 16 16 16 16 16 16 15 16 16 16 16 16 16 16 16 16 15 16 16 16 16 16 16 16 16 11 16
16 7 10 10 12 13 10 10 10 10 10 9 10 10 12 13 10 10 10 10 10 9 10 10 12 13 10 10 10 10 10 9 10 10 12 13 10 10 10 10 10 9 10 10 12 13 10 10 10 10 8 16
16 11 16 16 11 11 16 16 16 16 16 11 16 16 11 11 16 16 16 16 16 11 16 16 11 11 16 20 19 16 16 11 16 16 11 11 16 16 16 16 16 11 16 16 11 11 16 16 16 16 11 16
16 11 16 16 14 14 16 16 16 16 16 11 16 16 14 14 16 16 16 16 16 11 16 16 14 14 16 20 19 16 16 11 16 16 14 14 16 16 16 16 16 11 16 16 14 14 16 16 16 16 11 16
16 11 16 16 16 16 16 16 16 16 16 11 16 16 16 16 16 16 16 16 16 11 16 16 16 16 16 18 17 16 16 11 16 16 16 16 16 16 16 16 16 11 16 16 16 16 16 16 16 16 11 16
16 7 10 10 10 10 10 10 10 10 10 9 10 10 10 10 10 10 10 10 10 9 10 10 10 10 10 10 10 10 10 9 10 10 10 10 10 10 10 10 10 9 10 10 10 10 10 10 10 10 8 16
16 11 16 16 16 16 16 16 16 16 16 11 16 16 16 16 16 16 16 16 16 11 16 16 16 16 16 16 16 16 16 11 16 16 16 16 16 16 16 16 16 11 16 16 16 16 16 16 16 16 11 16
16 11 16 16 16 16 16 16 16 16 16 11 16 16 16 16 16 16 16 16 16 11 16 16 16 16 16 16 16 16 16 11 16 16 16 16 16 16 16 16 16 11 16 16 16 16 16 16 16 16 11 16
16 11 16 16 16 16 16 16 16 16 16 15 16 16 16 16 16 16 16 16 16 15 16 16 16 16 16 16 16 16 16 15 16 16 16 16 16 16 16 16 16 15 16 16 16 16 16 16 16 16 11 16
16 7 10 10 12 13 10 10 10 10 10 9 10 10 12 13 10 10 10 10 10 9 10 10 12 13 10 10 10 10 10 9 10 10 12 13 10 10 10 10 10 9 10 10 12 13 10 10 10 10 8 16
16 11 16 16 11 11 16 16 16 16 16 11 16 16 11 11 16 16 16 16 16 11 16 16 11 11 16 16 16 16 16 11 16 16 11 11 16 16 16 16 16 11 16 16 11 11 16 16 16 16 11 16
16 11 16 16 14 14 16 16 16 16 16 11 16 16 14 14 16 16 16 16 16 11 16 16 14 14 16 16 16 16 16 11 16 16 14 14 16 16 16 16 16 11 16 16 14 14 16 16 16 16 11 16
16 11 16 16 16 16 16 16 16 16 16 11 16 16 16 16 16 16 16 16 16 11 16 16 16 16 16 16 16 16 16 11 16 16 16 16 16 16 16 16 16 11 16 16 16 16 16 16 16 16 11 16
16 7 10 10 10 10 10 10 10 10 10 9 10 10 10 10 10 10 10 10 10 9 10 10 10 10 10 10 10 10 10 9 10 10 10 10 10 10 10 10 10 9 10 10 10 10 10 10 10 10 8 16
16 11 16 16 16 16 16 16 16 16 16 11 16 16 16 16 16 16 16 16 16 11 16 16 16 16 16 16 16 16 16 11 16 16 16 16 16 16 16 16 16 11 16 16 16 16 16 16 16 16 11 16
16 11 16 16 16 16 16 16 16 16 16 11 16 16 16 16 16 16 16 16 16 11 16 16 16 16 16 16 16 16 16 11 16 16 16 16 16 16 16 16 16 11 16 16 16 16 16 16 16 16 11 16
16 11 16 16 16 16 16 16 16 16 16 15 16 16 16 16 16 16 16 16 16 15 16 16 16 16 16 16 16 16 16 15 16 16 16 16 16 16 16 16 16 15 16 16 16 16 16 16 16 16 11 16
16 7 10 10 12 13 10 10 10 10 10 9 10 10 12 13 10 10 10 10 10 9 10 10 12 13 10 10 10 10 10 9 10 10 12 13 10 10 10 10 10 9 10 10 12 13 10 10 10 10 8 16
16 11 16 16 11 11 16 16 16 16 16 11 16 16 11 11 16 16 16 16 16 11 16 16 11 11 16 16 16 16 16 11 16 16 11 11 16 16 16 16 16 11 16 16 11 11 16 16 16 16 11 16
16 11 16 16 14 14 16 16 16 16 16 11 16 16 14 14 16 16 16 16 16 11 16 16 14 14 16 16 16 16 16 11 16 16 14 14 16 16 16 16 16 11 16 16 14 14 16 16 16 16 11 16
16 11 16 16 16 16 16 16 16 16 16 11 16 16 16 16 16 16 16 16 16 11 16 16 16 16 16 16 16 16 16 11 16 16 16 16 16 16 16 16 16 11 16 16 16 16 16 16 16 16 11 16
16 7 10 10 10 10 10 10 10 10 10 9 10 10 10 10 10 10 10 10 10 9 10 10 10 10 10 10 10 10 10 9 10 10 10 10 10 10 10 10 10 9 10 10 10 10 10 10 10 10 8 16
16 11 16 16 16 16 16 16 16 16 16 11 16 16 16 16 16 16 16 16 16 11 16 16 16 16 16 16 16 16 16 11 16 16 16 16 16 16 16 16 16 11 16 16 16 16 16 16 16 16 11 16
16 11 16 16 16 16 16 16 16 16 16 11 16 16 16 16 16 16 16 16 16 11 16 16 16 16 16 16 16 16 16 11 16 16 16 16 16 16 16 16 16 11 16 16 16 16 16 16 16 16 11 16
16 11 16 16 16 16 16 16 16 16 16 15 16 16 16 16 16 16 16 16 16 15 16 16 16 16 16 16 16 16 16 15 16 16 16 16 16 16 16 16 16 15 16 16 16 16 16 16 16 16 11 16
16 7 10 10 12 13 10 10 10 10 10 9 10 10 12 13 10 10 10 10 10 9 10 10 12 13 10 10 10 10 10 9 10 10 12 13 10 10 10 10 10 9 10 10 12 13 10 10 10 10 8 16
16 11 16 16 11 11 16 16 16 16 16 11 16 16 11 11 16 16 16 16 16 11 16 16 11 11 16 16 16 16 16 11 16 16 11 11 16 16 16 16 16 11 16 16 11 11 16 16 16 16 11 16
16 11 16 16 14 14 16 16 16 16 16 11 16 16 14 14 16 16 16 16 16 11 16 16 14 14 16 16 16 16 16 11 16 16 14 14 16 16 16 16 16 11 16 16 14 14 16 16 16 16 11 16
16 11 16 16 16 16 16 16 16 16 16 11 16 16 16 16 16 16 16 16 16 11 16 16 16 16 16 16 16 16 16 11 16 16 16 16 16 16 16 16 16 11 16 16 16 16 16 16 16 16 11 16
16 7 10 10 10 10 10 10 10 10 10 9 10 10 10 10 10 10 10 10 10 9 10 10 10 10 10 10 10 10 10 9 10 10 10 10 10 10 10 10 10 9 10 10 10 10 10 10 10 10 8 16
16 11 16 16 16 16 16 16 16 16 16 11 16 16 16 16 16 16 16 16 16 11 16 16 16 16 16 16 16 16 16 11 16 16 16 16 16 16 16 16 16 11 16 16 16 16 16 16 16 16 11 16
16 11 16 16 16 16 16 16 16 16 16 11 16 16 16 16 16 16 16 16 16 11 16 16 16 16 16 16 16 16 16 11 16 16 16 16 16 16 16 16 16 11 16 16 16 16 16 16 16 16 11 16
16 11 16 16 16 16 16 16 16 16 16 15 16 16 16 16 16 16 16 16 16 15 16 16 16 16 16 16 16 16 16 15 16 16 16 16 16 16 16 16 16 15 16 16 16 16 16 16 16 16 11 16
16 7 10 10 12 13 10 10 10 10 10 9 10 10 12 13 10 10 10 10 10 9 10 10 12 13 10 10 10 10 10 9 10 10 12 13 10 10 10 10 10 9 10 10 12 13 10 10 10 10 8 16
16 11 16 16 11 11 16 16 16 16 16 11 16 16 11 11 16 16 16 16 16 11 16 16 11 11 16 16 16 16 16 11 16 16 11 11 16 16 16 16 16 11 16 16 11 11 16 16 16 16 11 16
16 11 16 16 14 14 16 16 16 16 16 11 16 16 14 14 16 16 16 16 16 11 16 16 14 14 16 16 16 16 16 11 16 16 14 14 16 16 16 16 16 11 16 16 14 14 16 16 16 16 11 16
16 11 16 16 16 16 16 16 16 16 16 11 16 16 16 16 16 16 16 16 16 11 16 16 16 16 16 16 16 16 16 11 16 16 16 16 16 16 16 16 16 11 16 16 16 16 16 16 16 16 11 16
16 11 16 16 16 16 16 16 16 16 16 11 16 16 16 16 16 16 16 16 16 11 16 16 16 16 16 16 16 16 16 11 16 16 16 16 16 16 16 16 16 11 16 16 16 16 16 16 16 16 11 16
16 0 10 10 10 10 10 10 10 10 10 4 10 10 10 10 10 10 10 10 10 4 10 10 10 10 10 10 10 10 10 4 10 10 10 10 10 10 10 10 10 4 10 10 10 10 10 10 10 10 1 16
16 16 16 16 16 16 16 16 16 16 16 16 16 16 16 16 16 16 16 16 16 16 16 16 16 16 16 16 16 16 16 16 16 16 16 16 16 16 16 16 16 16 16 16 16 16 16 16 16 16 16 16