2 10 10 10 10 10 10 10 10 10 6 10 10 10 10 10 10 10 10 10 6 10 10 10 10 10 10 10 10 10 6 10 10 10 10 10 10 10 10 10 6 10 10 10 10 10 10 10 10 3
11 16 16 16 16 16 16 16 16 16 11 16 16 16 16 16 16 16 16 16 11 16 16 16 16 16 16 16 16 16 11 16 16 16 16 16 16 16 16 16 11 16 16 16 16 16 16 16 16 11
11 16 16 16 16 16 16 16 16 16 11 16 16 16 16 16 16 16 16 16 11 16 16 16 16 16 16 16 16 16 11 16 16 16 16 16 16 16 16 16 11 16 16 16 16 16 16 16 16 11
11 16 16 16 16 16 16 16 16 16 15 16 16 16 16 16 16 16 16 16 15 16 16 16 16 16 16 16 16 16 15 16 16 16 16 16 16 16 16 16 15 16 16 16 16 16 16 16 16 11
7 10 10 10 12 13 10 10 10 10 9 10 10 12 13 10 10 10 10 10 9 10 10 12 13 10 10 10 10 10 9 10 10 12 13 10 10 10 10 10 9 10 10 12 13 10 10 10 10 8
11 16 16 16 11 11 16 16 16 16 11 16 16 11 11 16 16 16 16 16 11 16 16 11 11 16 16 16 16 16 11 16 16 11 11 16 16 16 16 16 11 16 16 11 11 16 16 16 16 11
11 16 16 16 14 14 16 16 16 16 11 16 16 14 14 16 16 16 16 16 11 16 16 14 14 16 16 16 16 16 11 16 16 14 14 16 16 16 16 16 11 16 16 14 14 16 16 16 16 11
11 16 16 16 16 16 16 16 16 16 11 16 16 16 16 16 16 16 16 16 11 16 16 16 16 16 16 16 16 16 11 16 16 16 16 16 16 16 16 16 11 16 16 16 16 16 16 16 16 11
7 10 10 10 10 10 10 10 10 10 9 10 10 10 10 10 10 10 10 10 9 10 10 10 10 10 10 10 10 10 9 10 10 10 10 10 10 10 10 10 9 10 10 10 10 10 10 10 10 8
11 16 16 16 16 16 16 16 16 16 11 16 16 16 16 16 16 16 16 16 11 16 16 16 16 16 16 16 16 16 11 16 16 16 16 16 16 16 16 16 11 16 16 16 16 16 16 16 16 11
11 16 16 16 16 16 16 16 16 16 11 16 16 16 16 16 16 16 16 16 11 16 16 16 16 16 16 16 16 16 11 16 16 16 16 16 16 16 16 16 11 16 16 16 16 16 16 16 16 11
11 16 16 16 16 16 16 16 16 16 15 16 16 16 16 16 16 16 16 16 15 16 16 16 16 16 16 16 16 16 15 16 16 16 16 16 16 16 16 16 15 16 16 16 16 16 16 16 16 11
7 10 10 12 13 10 10 10 10 10 9 10 10 12 13 10 10 10 10 10 9 10 10 12 13 10 10 10 10 10 9 10 10 12 13 10 10 10 10 10 9 10 10 12 13 10 10 10 10 8
11 16 16 11 11 16 16 16 16 16 11 16 16 11 11 16 16 16 16 16 11 16 16 11 11 16 16 16 16 16 11 16 16 11 11 16 16 16 16 16 11 16 16 11 11 16 16 16 16 11
11 16 16 14 14 16 16 16 16 16 11 16 16 14 14 16 16 16 16 16 11 16 16 14 14 16 16 16 16 16 11 16 16 14 14 16 16 16 16 16 11 16 16 14 14 16 16 16 16 11
11 16 16 16 16 16 16 16 16 16 11 16 16 16 16 16 16 16 16 16 11 16 16 16 16 16 16 16 16 16 11 16 16 16 16 16 16 16 16 16 11 16 16 16 16 16 16 16 16 11
7 10 10 10 10 10 10 10 10 10 9 10 10 10 10 10 10 10 10 10 9 10 10 10 10 10 10 10 10 10 9 10 10 10 10 10 10 10 10 10 9 10 10 10 10 10 10 10 10 8
11 16 16 16 16 16 16 16 16 16 11 16 16 16 16 16 16 16 16 16 11 16 16 16 16 16 16 16 16 16 11 16 16 16 16 16 16 16 16 16 11 16 16 16 16 16 16 16 16 11
11 16 16 16 16 16 16 16 16 16 11 16 16 16 16 16 16 16 16 16 11 16 16 16 16 16 16 16 16 16 11 16 16 16 16 16 16 16 16 16 11 16 16 16 16 16 16 16 16 11
11 16 16 16 16 16 16 16 16 16 15 16 16 16 16 16 16 16 16 16 15 16 16 16 16 16 16 16 16 16 15 16 16 16 16 16 16 16 16 16 15 16 16 16 16 16 16 16 16 11
7 10 10 12 13 10 10 10 10 10 9 10 10 12 13 10 10 10 10 10 9 10 10 12 13 10 10 10 10 10 9 10 10 12 13 10 10 10 10 10 9 10 10 12 13 10 10 10 10 8
11 16 16 11 11 16 16 16 16 16 11 16 16 11 11 16 16 16 16 16 11 16 16 11 11 16 16 16 16 16 11 16 16 11 11 16 16 16 16 16 11 16 16 11 11 16 16 16 16 11
11 16 16 14 14 16 16 16 16 16 11 16 16 14 14 16 16 16 16 16 11 16 16 14 14 16 16 16 16 16 11 16 16 14 14 16 16 16 16 16 11 16 16 14 14 16 16 16 16 11
11 16 16 16 16 16 16 16 16 16 11 16 16 16 16 16 16 16 16 16 11 16 16 16 16 16 16 16 16 16 11 16 16 16 16 16 16 16 16 16 11 16 16 16 16 16 16 16 16 11
7 10 10 10 10 10 10 10 10 10 9 10 10 10 10 10 10 10 10 10 9 10 10 10 10 10 10 10 10 10 9 10 10 10 10 10 10 10 10 10 9 10 10 10 10 10 10 10 10 8
11 16 16 16 16 16 16 16 16 16 11 16 16 16 16 16 16 16 16 16 11 16 16 16 16 16 16 16 16 16 11 16 16 16 16 16 16 16 16 16 11 16 16 16 16 16 16 16 16 11
11 16 16 16 16 16 16 16 16 16 11 16 16 16 16 16 16 16 16 16 11 16 16 16 16 16 16 16 16 16 11 16 16 16 16 16 16 16 16 16 11 16 16 16 16 16 16 16 16 11
11 16 16 16 16 16 16 16 16 16 15 16 16 16 16 16 16 16 16 16 15 16 16 16 16 16 16 16 16 16 15 16 16 16 16 16 16 16 16 16 15 16 16 16 16 16 16 16 16 11
7 10 10 12 13 10 10 10 10 10 9 10 10 12 13 10 10 10 10 10 9 10 10 12 13 10 10 10 10 10 9 10 10 12 13 10 10 10 10 10 9 10 10 12 13 10 10 10 10 8
11 16 16 11 11 16 16 16 16 16 11 16 16 11 11 16 16 16 16 16 11 16 16 11 11 16 16 16 16 16 11 16 16 11 11 16 16 16 16 16 11 16 16 11 11 16 16 16 16 11
11 16 16 14 14 16 16 16 16 16 11 16 16 14 14 16 16 16 16 16 11 16 16 14 14 16 16 16 16 16 11 16 16 14 14 16 16 16 16 16 11 16 16 14 14 16 16 16 16 11
11 16 16 16 16 16 16 16 16 16 11 16 16 16 16 16 16 16 16 16 11 16 16 16 16 16 16 16 16 16 11 16 16 16 16 16 16 16 16 16 11 16 16 16 16 16 16 16 16 11
7 10 10 10 10 10 10 10 10 10 9 10 10 10 10 10 10 10 10 10 9 10 10 10 10 10 10 10 10 10 9 10 10 10 10 10 10 10 10 10 9 10 10 10 10 10 10 10 10 8
11 16 16 16 16 16 16 16 16 16 11 16 16 16 16 16 16 16 16 16 11 16 16 16 16 16 16 16 16 16 11 16 16 16 16 16 16 16 16 16 11 16 16 16 16 16 16 16 16 11
11 16 16 16 16 16 16 16 16 16 11 16 16 16 16 16 16 16 16 16 11 16 16 16 16 16 16 16 16 16 11 16 16 16 16 16 16 16 16 16 11 16 16 16 16 16 16 16 16 11
11 16 16 16 16 16 16 16 16 16 15 16 16 16 16 16 16 16 16 16 15 16 16 16 16 16 16 16 16 16 15 16 16 16 16 16 16 16 16 16 15 16 16 16 16 16 16 16 16 11
7 10 10 12 13 10 10 10 10 10 9 10 10 12 13 10 10 10 10 10 9 10 10 12 13 10 10 10 10 10 9 10 10 12 13 10 10 10 10 10 9 10 10 12 13 10 10 10 10 8
11 16 16 11 11 16 16 16 16 16 11 16 16 11 11 16 16 16 16 16 11 16 16 11 11 16 16 16 16 16 11 16 16 11 11 16 16 16 16 16 11 16 16 11 11 16 16 16 16 11
11 16 16 14 14 16 16 16 16 16 11 16 16 14 14 16 16 16 16 16 11 16 16 14 14 16 16 16 16 16 11 16 16 14 14 16 16 16 16 16 11 16 16 14 14 16 16 16 16 11
11 16 16 16 16 16 16 16 16 16 11 16 16 16 16 16 16 16 16 16 11 16 16 16 16 16 16 16 16 16 11 16 16 16 16 16 16 16 16 16 11 16 16 16 16 16 16 16 16 11
7 10 10 10 10 10 10 10 10 10 9 10 10 10 10 10 10 10 10 10 9 10 10 10 10 10 10 10 10 10 9 10 10 10 10 10 10 10 10 10 9 10 10 10 10 10 10 10 10 8
11 16 16 16 16 16 16 16 16 16 11 16 16 16 16 16 16 16 16 16 11 16 16 16 16 16 16 16 16 16 11 16 16 16 16 16 16 16 16 16 11 16 16 16 16 16 16 16 16 11
11 16 16 16 16 16 16 16 16 16 11 16 16 16 16 16 16 16 16 16 11 16 16 16 16 16 16 16 16 16 11 16 16 16 16 16 16 16 16 16 11 16 16 16 16 16 16 16 16 11
11 16 16 16 16 16 16 16 16 16 15 16 16 16 16 16 16 16 16 16 15 16 16 16 16 16 16 16 16 16 15 16 16 16 16 16 16 16 16 16 15 16 16 16 16 16 16 16 16 11
7 10 10 12 13 10 10 10 10 10 9 10 10 12 13 10 10 10 10 10 9 10 10 12 13 10 10 10 10 10 9 10 10 12 13 10 10 10 10 10 9 10 10 12 13 10 10 10 10 8
11 16 16 11 11 16 16 16 16 16 11 16 16 11 11 16 16 16 16 16 11 16 16 11 11 16 16 16 16 16 11 16 16 11 11 16 16 16 16 16 11 16 16 11 11 16 16 16 16 11
11 16 16 14 14 16 16 16 16 16 11 16 16 14 14 16 16 16 16 16 11 16 16 14 14 16 16 16 16 16 11 16 16 14 14 16 16 16 16 16 11 16 16 14 14 16 16 16 16 11
11 16 16 16 16 16 16 16 16 16 11 16 16 16 16 16 16 16 16 16 11 16 16 16 16 16 16 16 16 16 11 16 16 16 16 16 16 16 16 16 11 16 16 16 16 16 16 16 16 11
11 16 16 16 16 16 16 16 16 16 11 16 16 16 16 16 16 16 16 16 11 16 16 16 16 16 16 16 16 16 11 16 16 16 16 16 16 16 16 16 11 16 16 16 16 16 16 16 16 11
0 10 10 10 10 10 10 10 10 10 4 10 10 10 10 10 10 10 10 10 4 10 10 10 10 10 10 10 10 10 4 10 10 10 10 10 10 10 10 10 4 10 10 10 10 10 10 10 10 1