70 70 73 72 72 72 72 72 70 72 70 59 72 72 72 72 72 70 72 70 72 72 72 72 72 70 72 70 70 72 72 72 72 72 70 72 70 70 70 72 72 72 72 72 70 72 70 72 70 72
96 97 74 72 72 72 61 10 10 10 10 8 72 59 72 72 72 70 59 70 70 72 72 72 72 72 70 72 70 70 72 72 72 72 72 70 72 59 70 70 72 72 72 123 123 70 72 72 123 70
98 99 75 70 59 72 70 72 72 70 72 0 10 8 70 70 2 10 9 6 60 103 104 70 70 91 61 10 10 3 72 70 72 2 10 10 6 4 10 10 3 71 71 124 124 71 71 71 124 72
100 2 10 10 9 10 10 10 10 3 71 113 71 11 17 18 11 91 5 5 86 105 106 17 18 92 93 71 100 11 118 72 113 11 70 72 5 86 72 70 7 10 10 10 10 10 10 71 70 72
101 11 70 72 5 103 104 17 18 11 114 115 97 11 96 97 11 92 93 87 88 107 72 19 20 94 95 71 101 11 119 120 114 11 96 97 87 88 17 18 11 123 72 96 97 17 18 71 72 100
102 11 123 123 70 105 106 19 20 11 116 117 99 15 98 99 15 94 95 89 90 71 71 71 71 71 71 71 102 11 121 122 117 15 98 99 89 90 19 20 15 124 70 98 99 19 20 71 73 101
70 5 124 124 71 107 71 71 71 7 10 10 13 9 12 10 4 10 10 6 10 10 10 10 10 6 10 10 10 4 10 10 13 9 12 10 10 10 10 13 4 12 10 10 3 100 100 100 74 73
72 100 2 60 71 71 71 70 72 11 70 72 113 14 71 123 123 123 123 11 123 123 123 123 123 11 123 123 123 123 123 123 123 14 123 123 123 123 123 123 123 123 123 123 11 101 101 101 75 74
72 101 11 96 97 2 13 10 10 1 72 114 115 11 71 124 124 124 124 11 124 124 124 124 124 11 124 124 124 124 124 124 124 11 124 124 124 124 124 124 124 124 124 124 11 102 102 102 70 100
70 102 15 98 99 11 70 71 70 70 72 116 117 15 72 71 71 2 13 9 12 3 71 71 100 11 70 70 72 70 70 72 70 15 70 72 70 72 72 70 70 72 70 70 11 100 72 70 70 101
72 61 4 12 10 8 70 71 71 71 71 73 2 4 10 60 71 11 72 15 72 11 73 73 101 11 70 61 10 10 10 10 13 9 12 10 10 10 10 60 70 70 70 2 1 101 17 18 72 100
72 123 17 18 123 5 100 70 96 97 71 74 11 17 18 72 70 7 13 9 12 8 74 74 73 11 123 123 123 123 123 123 123 14 123 123 123 123 123 123 123 123 123 11 70 102 19 20 73 101
70 124 19 20 124 123 101 72 98 99 71 75 11 19 20 70 70 11 72 14 72 11 100 75 74 11 124 124 124 124 124 124 124 11 124 124 124 124 124 124 124 124 124 11 72 123 123 70 74 73
72 72 2 10 3 124 102 61 6 60 71 61 4 10 6 60 70 0 10 4 10 1 101 71 75 11 70 70 72 70 70 72 70 15 70 72 70 72 72 70 72 70 70 11 70 124 124 72 75 74
70 73 11 73 11 71 103 104 14 108 109 71 76 77 11 81 82 71 71 71 71 71 102 2 10 1 70 61 10 10 10 10 13 9 12 10 10 10 10 60 70 70 70 0 10 10 10 3 70 100
72 74 11 74 11 71 105 106 11 110 111 71 78 79 15 83 84 71 2 10 10 10 10 8 123 123 123 123 123 123 123 123 123 14 123 123 123 123 123 123 123 123 123 123 123 123 123 11 73 101
72 75 15 73 11 71 107 72 15 72 112 71 80 2 4 3 85 71 15 72 72 73 73 11 124 124 124 124 124 124 124 124 124 11 124 124 124 124 124 124 124 124 124 124 124 124 124 11 74 100
72 61 8 74 0 10 10 13 9 12 10 10 10 8 72 11 71 71 11 72 72 74 74 11 70 70 70 70 72 70 70 72 70 15 70 72 70 72 72 70 70 70 72 70 70 70 70 11 75 101
70 73 14 100 70 71 118 72 14 72 113 71 91 0 6 1 86 71 0 10 60 96 97 11 123 123 123 61 10 10 10 10 13 9 12 10 10 10 10 60 17 18 123 17 18 17 18 11 70 102
70 74 11 101 70 71 119 120 11 114 115 71 92 93 14 87 88 71 71 71 71 98 99 15 124 124 124 72 72 72 72 72 72 14 71 71 71 118 72 70 19 20 124 19 20 19 20 11 70 100
72 73 11 100 72 71 121 122 11 116 117 71 94 95 11 89 90 70 70 72 2 10 13 9 12 10 10 10 10 10 10 10 13 9 12 10 3 119 120 71 72 2 10 10 10 10 10 1 70 101
70 74 11 101 72 72 71 71 11 71 71 72 100 73 11 118 72 72 113 73 11 118 72 14 71 71 71 123 123 123 123 81 82 14 71 71 11 121 122 71 71 15 71 86 71 118 72 70 72 100
72 73 11 100 17 18 72 100 11 96 97 71 101 74 11 119 120 114 115 74 11 119 120 0 10 3 100 124 124 124 124 83 84 11 91 71 0 10 10 10 13 8 87 88 71 119 120 70 73 101
70 74 11 101 19 20 73 101 15 98 99 71 102 75 11 121 122 116 117 75 15 121 122 70 70 15 101 73 103 104 71 72 85 11 92 93 123 123 123 108 109 14 89 90 59 121 122 70 74 73
70 100 11 73 71 100 74 73 7 10 10 12 60 86 0 10 10 10 10 13 9 12 10 10 10 8 100 74 105 106 71 71 71 11 94 95 124 124 124 110 111 0 10 10 9 12 10 3 75 74
72 101 11 74 71 101 75 74 14 118 72 71 87 88 73 100 70 70 81 82 14 76 77 81 82 14 101 75 107 2 10 10 13 4 12 10 10 3 71 71 112 123 81 82 14 103 104 11 71 100
70 73 11 100 71 102 71 100 11 119 120 71 89 90 74 101 17 18 83 94 11 78 79 83 84 11 73 70 70 11 118 72 71 71 70 108 109 11 71 72 71 124 83 84 11 105 106 11 72 101
72 74 11 101 72 72 72 101 11 121 122 71 71 71 75 102 19 20 72 85 11 80 72 72 85 11 74 70 86 15 119 120 96 97 123 110 111 14 71 71 70 70 71 85 11 107 72 11 71 100
70 73 11 100 72 72 72 73 0 10 13 6 12 10 12 10 10 6 12 10 1 71 72 72 70 11 75 87 88 11 121 122 98 99 124 72 112 11 17 18 123 123 70 71 11 71 70 5 73 101
70 74 11 101 123 96 97 74 123 17 18 14 103 104 71 108 109 11 71 71 71 71 71 71 71 15 118 89 90 0 10 10 13 6 12 10 10 1 19 20 124 124 70 71 11 71 70 100 74 73
72 75 11 102 124 98 99 75 124 19 20 11 105 106 71 110 111 11 91 72 70 70 70 72 86 11 119 120 123 123 96 97 123 14 100 72 72 72 73 70 70 72 118 72 11 71 72 101 75 73
70 71 0 12 10 10 6 10 10 10 13 1 107 71 72 71 112 11 92 93 123 123 123 87 88 11 121 122 124 124 98 99 124 11 101 123 96 97 74 123 17 18 119 120 11 71 72 100 70 100
72 71 71 123 123 123 14 71 71 71 71 71 71 71 59 71 71 15 94 95 124 124 124 89 90 7 12 10 10 60 70 72 70 11 102 124 98 99 75 124 19 20 121 122 11 71 73 101 72 101
70 70 71 124 124 124 11 118 70 70 72 70 70 113 11 91 70 0 12 10 10 10 10 10 13 1 113 70 70 70 100 70 86 7 12 10 10 10 10 10 10 10 10 13 1 71 74 73 73 100
72 70 91 61 10 10 8 119 120 123 123 123 114 115 11 92 93 123 123 17 18 96 97 123 123 114 115 123 123 123 101 87 88 14 73 100 100 72 72 72 73 70 70 70 118 72 75 73 74 101
72 72 92 93 108 109 11 121 122 124 124 124 116 117 11 94 95 124 124 19 20 98 99 124 124 116 117 124 124 124 102 89 90 11 74 101 101 123 96 97 74 123 17 18 119 120 71 75 75 73
70 72 94 95 110 111 0 13 6 12 10 10 10 13 4 12 10 10 10 10 10 10 10 10 10 10 10 10 10 10 10 10 13 8 73 102 102 124 98 99 75 124 19 20 121 122 71 71 71 74
72 71 71 71 71 112 71 71 14 73 76 77 123 17 18 123 96 97 123 123 71 123 17 18 123 96 97 123 123 17 18 81 82 14 74 70 71 59 118 70 72 72 70 113 2 12 10 60 86 100
70 70 59 91 71 72 71 113 11 74 78 79 124 19 20 124 98 99 124 124 71 124 19 20 124 98 90 124 124 19 20 83 84 11 73 72 71 14 119 120 17 18 114 115 14 71 71 87 88 101
72 70 11 92 93 123 114 115 11 100 80 2 10 10 10 10 10 10 10 10 12 10 10 3 118 71 70 72 72 70 71 71 85 11 74 70 71 11 121 122 19 20 116 117 11 71 72 89 90 100
72 72 11 94 95 124 116 117 11 101 71 14 103 104 17 18 96 97 123 17 18 96 97 11 119 120 123 17 18 123 96 97 123 11 75 73 118 0 10 10 10 10 10 10 8 118 72 73 71 101
70 72 7 10 12 6 10 12 8 73 71 11 105 106 19 20 98 99 124 19 20 98 99 15 121 122 124 19 20 124 98 99 124 15 71 74 119 120 123 76 77 123 81 82 11 119 120 74 72 73
103 104 14 73 100 14 100 73 11 74 71 11 107 91 61 10 10 10 10 13 6 10 13 9 12 10 10 10 10 13 10 10 10 8 71 100 121 122 124 78 79 124 83 84 14 121 122 75 71 74
105 106 11 74 101 11 101 74 11 75 71 11 72 92 93 123 123 123 96 97 11 72 71 14 76 77 123 17 18 123 123 108 109 14 71 101 71 71 71 81 59 71 71 85 7 10 60 71 73 100
107 61 1 75 102 11 73 100 14 71 71 15 72 94 95 124 124 124 98 99 11 70 71 11 78 79 124 19 20 124 124 110 111 11 71 73 71 72 71 86 11 118 72 71 11 103 104 71 74 101
72 50 72 71 71 11 74 101 11 118 72 0 10 10 10 10 10 10 10 10 1 113 73 11 80 71 71 71 71 71 71 71 112 11 71 74 123 123 87 88 11 119 120 71 11 105 106 71 75 73
70 70 70 70 71 11 100 73 11 119 120 123 123 17 18 123 96 97 123 123 114 115 74 11 71 71 70 70 70 70 70 71 71 11 71 75 124 124 89 90 11 121 122 71 15 107 71 70 71 74
72 70 72 70 118 5 101 74 11 121 122 124 124 19 20 124 98 99 124 124 116 117 75 15 71 70 70 72 72 72 70 70 71 0 12 10 10 10 10 13 4 12 10 10 1 71 70 70 71 75
72 72 72 72 119 120 73 75 0 12 10 10 10 10 10 10 10 10 10 10 10 10 10 1 70 70 72 70 72 72 72 70 70 70 70 72 70 72 72 72 70 70 70 70 72 70 72 72 72 70
70 72 70 72 121 122 74 72 72 72 72 72 70 70 72 70 72 72 72 70 72 70 72 70 72 72 72 72 70 72 72 72 72 72 72 72 72 70 72 72 72 72 72 72 72 72 70 72 72 72

