16 16 16 16 16 16 16 16 16 16 16 16 16 16 16 16 16 16 16 16 16 16 16 16 16 16 16 16 16 16 16 16 16 16 16 16 16 16 16 16 16 16 16 16 16 16 16 16 16 16
16 16 16 16 16 16 16 16 16 16 16 16 16 16 16 16 16 16 16 16 16 16 16 16 16 16 16 16 16 16 16 16 16 16 16 16 16 16 16 16 16 16 16 16 16 16 16 16 16 16
16 16 0 10 10 10 10 9 9 10 10 10 9 10 9 10 9 9 10 9 10 10 10 10 9 10 10 10 9 10 9 10 9 10 10 10 9 10 10 10 9 10 9 10 9 10 10 1 16 16
16 16 11 16 16 16 16 23 16 16 16 16 11 16 16 16 16 11 16 16 16 16 16 16 11 16 16 16 16 16 24 16 16 16 16 16 23 16 16 16 16 16 11 16 16 16 16 11 16 16
16 16 11 16 16 16 16 23 16 16 16 16 11 16 16 16 16 11 16 16 16 16 16 16 11 16 16 16 16 16 24 16 16 16 16 16 23 16 16 16 16 16 11 16 16 16 16 11 16 16
16 16 11 16 16 16 16 23 16 16 16 16 11 16 16 16 16 11 16 16 16 16 16 16 11 16 16 16 16 16 24 16 16 16 16 16 23 16 16 16 16 16 11 16 16 16 16 11 16 16
16 16 11 16 16 16 16 23 16 16 16 16 11 16 16 16 16 11 16 16 16 16 16 16 11 16 16 16 16 16 24 16 16 16 16 16 23 16 16 16 16 16 11 16 16 16 16 11 16 16
16 16 9 21 21 21 21 9 9 10 10 10 9 10 9 10 9 9 10 9 10 10 10 10 9 16 16 16 16 16 9 16 16 16 16 16 9 16 16 16 16 16 9 16 16 16 16 9 16 16
16 16 9 16 16 16 16 9 16 16 16 16 9 16 16 16 16 9 16 16 16 16 16 16 9 21 21 21 9 21 9 21 9 21 21 21 9 10 10 10 9 10 9 10 9 10 10 9 16 16
16 16 11 16 16 16 16 11 16 16 16 16 24 16 16 16 16 11 16 16 16 16 16 16 11 16 16 16 16 16 23 16 16 16 16 16 24 16 16 16 16 16 11 16 16 16 16 11 16 16
16 16 11 16 16 16 16 11 16 16 16 16 24 16 16 16 16 11 16 16 16 16 16 16 11 16 16 16 16 16 23 16 16 16 16 16 24 16 16 16 16 16 11 16 16 16 16 11 16 16
16 16 11 16 16 16 16 11 16 16 16 16 24 16 16 16 16 11 16 16 16 16 16 16 11 16 16 16 16 16 23 16 16 16 16 16 24 16 16 16 16 16 11 16 16 16 16 11 16 16
16 16 9 10 10 10 10 9 9 22 22 22 9 10 9 10 9 9 10 9 10 10 10 10 9 16 16 16 16 16 9 16 16 16 16 16 9 16 16 16 16 16 9 16 16 16 16 9 16 16
16 16 11 16 16 16 16 11 16 16 16 16 11 16 16 16 16 11 16 16 16 16 16 16 11 16 16 16 16 16 23 16 16 16 16 16 24 16 16 16 16 16 11 16 16 16 16 11 16 16
16 16 9 16 16 16 16 9 16 16 16 16 9 16 16 16 16 9 16 16 16 16 16 16 9 22 22 22 9 22 9 22 9 22 22 22 9 10 10 10 9 10 9 10 9 10 10 9 16 16
16 16 11 16 16 16 16 11 16 16 16 16 11 16 16 16 16 11 16 16 16 16 16 16 11 16 16 16 16 16 11 16 16 16 16 16 11 16 16 16 16 16 11 16 16 16 16 11 16 16
16 16 11 16 16 16 16 11 16 16 16 16 11 16 16 16 16 11 16 16 16 16 16 16 11 16 16 16 16 16 11 16 16 16 16 16 11 16 16 16 16 16 11 16 16 16 16 11 16 16
16 16 9 10 10 10 10 9 9 10 10 10 9 10 9 10 9 9 10 9 10 10 10 10 9 16 16 16 16 16 9 16 16 16 16 16 9 16 16 16 16 16 9 16 16 16 16 9 16 16
16 16 11 16 16 16 16 11 16 16 16 16 11 16 16 16 16 11 16 16 16 16 16 16 11 16 16 16 16 16 11 16 16 16 16 16 11 16 16 16 16 16 11 16 16 16 16 11 16 16
16 16 9 16 16 16 16 9 16 16 16 16 9 16 16 16 16 9 16 16 16 16 16 9 9 10 10 10 9 10 9 10 9 10 10 10 9 10 10 10 9 10 9 10 9 10 10 9 16 16
16 16 11 16 16 16 16 11 16 16 16 16 11 16 16 16 16 11 16 16 16 16 16 11 11 16 16 16 16 16 11 16 16 16 16 16 11 16 16 16 16 16 11 16 16 16 16 11 16 16
16 16 11 16 16 16 16 11 16 16 16 16 11 16 16 16 16 11 16 16 16 16 16 11 11 16 16 16 16 16 11 16 16 16 16 16 11 16 16 16 16 16 11 16 16 16 16 11 16 16
16 16 11 16 16 16 16 11 16 16 16 16 11 16 16 16 16 11 16 16 16 16 16 11 11 16 16 16 16 16 11 16 16 16 16 16 11 16 16 16 16 16 11 16 16 16 16 11 16 16
16 16 11 16 16 16 16 11 16 16 16 16 11 16 16 16 16 11 16 16 16 16 16 11 11 16 16 16 16 16 11 16 16 16 16 16 11 16 16 16 16 16 11 16 16 16 16 11 16 16
16 16 9 10 10 10 10 9 9 10 10 10 9 10 9 10 9 9 10 9 10 10 10 9 9 10 10 10 9 10 9 10 9 10 10 10 9 10 10 10 9 10 9 10 9 10 10 9 16 16
16 16 11 16 16 16 16 16 24 16 16 16 16 16 16 16 23 16 16 16 16 16 16 16 11 16 16 16 24 16 16 16 23 16 16 16 24 16 16 16 23 16 16 16 24 16 16 11 16 16
16 16 11 16 16 16 16 16 24 16 16 16 16 16 16 16 23 16 16 16 16 16 16 16 11 16 16 16 24 16 16 16 23 16 16 16 24 16 16 16 23 16 16 16 24 16 16 11 16 16
16 16 11 16 16 16 16 16 24 16 16 16 16 16 16 16 23 16 16 16 16 16 16 16 11 16 16 16 24 16 16 16 23 16 16 16 24 16 16 16 23 16 16 16 24 16 16 11 16 16
16 16 9 16 16 16 16 16 9 16 16 16 16 16 16 16 9 16 16 16 16 16 16 16 9 21 21 21 9 21 9 21 9 21 21 21 9 21 21 21 9 21 9 21 9 21 21 9 16 16
16 16 11 16 16 16 16 16 24 16 16 16 16 16 16 16 23 16 16 16 16 16 16 16 11 16 16 16 24 16 16 16 23 16 16 16 24 16 16 16 23 16 16 16 24 16 16 11 16 16
16 16 9 21 21 21 21 9 9 21 21 21 9 21 9 21 9 9 10 9 10 10 10 10 9 16 16 16 9 16 16 16 9 16 16 16 9 16 16 16 9 16 16 16 9 16 16 9 16 16
16 16 11 16 16 16 16 16 23 16 16 16 16 16 16 16 24 16 16 16 16 16 16 16 11 16 16 16 24 16 16 16 23 16 16 16 24 16 16 16 23 16 16 16 24 16 16 11 16 16
16 16 9 16 16 16 16 16 9 16 16 16 16 16 16 16 9 16 16 16 16 16 16 16 9 22 22 22 9 22 9 22 9 22 22 22 9 22 22 22 9 22 9 22 9 22 22 9 16 16
16 16 11 16 16 16 16 16 23 16 16 16 16 16 16 16 24 16 16 16 16 16 16 16 11 16 16 16 24 16 16 16 23 16 16 16 24 16 16 16 23 16 16 16 24 16 16 11 16 16
16 16 11 16 16 16 16 16 23 16 16 16 16 16 16 16 24 16 16 16 16 16 16 16 11 16 16 16 24 16 16 16 23 16 16 16 24 16 16 16 23 16 16 16 24 16 16 11 16 16
16 16 11 16 16 16 16 16 23 16 16 16 16 16 16 16 24 16 16 16 16 16 16 16 11 16 16 16 24 16 16 16 23 16 16 16 24 16 16 16 23 16 16 16 24 16 16 11 16 16
16 16 9 16 16 16 16 16 9 16 16 16 16 16 16 16 9 16 16 16 16 16 16 16 9 21 21 21 9 21 9 21 9 21 21 21 9 21 21 21 9 21 9 21 9 21 21 9 16 16
16 16 11 16 16 16 16 16 23 16 16 16 16 16 16 16 24 16 16 16 16 16 16 16 11 16 16 16 24 16 16 16 23 16 16 16 24 16 16 16 23 16 16 16 24 16 16 11 16 16
16 16 9 22 22 22 22 9 9 22 22 22 9 22 9 22 9 9 10 9 10 10 10 10 9 16 16 16 9 16 16 16 9 16 16 16 9 16 16 16 9 16 16 16 9 16 16 9 16 16
16 16 11 16 16 16 16 16 11 16 16 16 16 16 16 16 11 16 16 16 16 16 16 16 11 16 16 16 24 16 16 16 23 16 16 16 24 16 16 16 23 16 16 16 24 16 16 11 16 16
16 16 9 16 16 16 16 16 9 16 16 16 16 16 16 16 9 16 16 16 16 16 16 16 9 22 22 22 9 22 9 22 9 22 22 22 9 22 22 22 9 22 9 22 9 22 22 9 16 16
16 16 11 16 16 16 16 16 11 16 16 16 16 16 16 16 11 16 16 16 16 16 16 16 11 16 16 16 24 16 16 16 23 16 16 16 24 16 16 16 23 16 16 16 24 16 16 11 16 16
16 16 11 16 16 16 16 16 11 16 16 16 16 16 16 16 11 16 16 16 16 16 16 16 11 16 16 16 24 16 16 16 23 16 16 16 24 16 16 16 23 16 16 16 24 16 16 11 16 16
16 16 11 16 16 16 16 16 11 16 16 16 16 16 16 16 11 16 16 16 16 16 16 16 11 16 16 16 24 16 16 16 23 16 16 16 24 16 16 16 23 16 16 16 24 16 16 11 16 16
16 16 9 16 16 16 16 16 9 16 16 16 16 16 16 16 9 16 16 16 16 16 16 16 9 21 21 21 9 21 9 21 9 21 21 21 9 21 21 21 9 21 9 21 9 21 21 9 16 16
16 16 11 16 16 16 16 16 11 16 16 16 16 16 16 16 11 16 16 16 16 16 16 16 11 16 16 16 24 16 16 16 23 16 16 16 24 16 16 16 23 16 16 16 24 16 16 11 16 16
16 16 11 16 16 16 16 16 11 16 16 16 16 16 16 16 11 16 16 16 16 16 16 16 11 16 16 16 24 16 16 16 23 16 16 16 24 16 16 16 23 16 16 16 24 16 16 11 16 16
16 16 2 10 10 10 10 9 9 10 10 10 9 10 9 10 9 9 10 9 10 10 10 10 9 10 10 10 9 10 9 10 9 10 10 10 9 10 10 10 9 10 9 10 9 10 10 3 16 16
16 16 16 16 16 16 16 16 16 16 16 16 16 16 16 16 16 16 16 16 16 16 16 16 16 16 16 16 16 16 16 16 16 16 16 16 16 16 16 16 16 16 16 16 16 16 16 16 16 16
16 16 16 16 16 16 16 16 16 16 16 16 16 16 16 16 16 16 16 16 16 16 16 16 16 16 16 16 16 16 16 16 16 16 16 16 16 16 16 16 16 16 16 16 16 16 16 16 16 16