16 16 16 16 16 16 16 16 16 16 16 16 16 16 16 16 16 16 16 16 16 16 16 16 16 16 16 16 16 16 16 16 16 16 16 16 16 16 16 16 16 16 16 16 16 16 16 16 16 16
16 16 16 16 11 16 16 16 16 16 16 16 11 16 16 16 16 16 16 16 11 16 16 16 16 16 16 16 11 16 16 16 16 16 16 16 11 16 16 16 16 16 16 16 23 16 16 16 16 16
16 16 16 16 11 16 16 16 16 16 16 16 11 16 16 16 16 16 16 16 11 16 16 16 16 16 16 16 11 16 16 16 16 16 16 16 11 16 16 16 16 16 16 16 23 16 16 16 16 16
16 16 16 16 11 16 16 16 16 16 16 16 11 16 16 16 16 16 16 16 11 16 16 16 16 16 16 16 11 16 16 16 16 16 16 16 11 16 16 16 16 16 16 16 23 16 16 16 16 16
16 16 16 16 11 16 16 16 16 16 16 16 11 16 16 16 16 16 16 16 11 16 16 16 16 16 16 16 11 16 16 16 16 16 16 16 11 16 16 16 16 16 16 16 23 16 16 16 16 16
16 10 10 10 9 10 10 9 10 10 9 16 9 16 21 21 21 21 21 21 9 21 21 21 21 21 21 21 9 22 22 22 22 22 22 22 9 10 10 10 10 10 10 10 9 10 10 10 10 16
16 16 16 16 11 16 16 11 16 16 16 16 11 16 16 16 16 16 16 16 11 16 16 16 16 16 16 16 11 16 16 16 16 16 16 16 11 16 16 16 16 16 16 16 23 16 16 16 16 16
16 16 16 16 11 16 16 11 16 16 16 16 11 16 16 16 16 16 16 16 11 16 16 16 16 16 16 16 11 16 16 16 16 16 16 16 11 16 16 16 16 16 16 16 23 16 16 16 16 16
16 16 16 10 11 10 10 9 10 10 9 10 11 16 16 16 16 16 16 16 11 16 16 16 16 16 16 16 11 16 16 16 16 16 16 16 11 16 16 16 16 16 16 16 23 16 16 16 16 16
16 16 16 16 16 16 16 11 16 16 11 16 11 16 16 16 16 16 16 16 11 16 16 16 16 16 16 16 11 16 16 16 16 16 16 16 11 16 16 16 16 16 16 16 23 16 16 16 16 16
16 16 16 16 16 16 16 11 16 16 11 16 9 16 10 10 10 10 10 10 9 10 10 10 10 10 10 10 9 10 10 10 10 10 10 10 9 10 10 10 10 10 10 10 9 10 10 10 10 16
16 16 16 16 16 16 16 11 16 16 11 16 11 16 16 16 16 16 16 16 11 16 16 16 16 16 16 16 11 16 16 16 16 16 16 16 11 16 16 16 16 16 16 16 23 16 16 16 16 16
16 10 10 10 10 10 10 9 10 16 9 16 11 16 16 16 16 16 16 16 11 16 16 16 16 16 16 16 11 16 16 16 16 16 16 16 11 16 16 16 16 16 16 16 23 16 16 16 16 16
16 16 16 16 16 16 16 11 16 16 11 16 11 16 16 16 16 16 16 16 11 16 16 16 16 16 16 16 11 16 16 16 16 16 16 16 11 16 16 16 16 16 16 16 23 16 16 16 16 16
16 16 16 16 16 16 16 11 16 16 11 16 11 16 16 16 16 16 16 16 11 16 16 16 16 16 16 16 11 16 16 16 16 16 16 16 11 16 16 16 16 16 16 16 23 16 16 16 16 16
16 16 16 16 16 16 16 11 16 16 11 16 11 16 16 16 16 16 16 16 11 16 16 16 16 16 16 16 11 16 16 16 16 16 16 16 11 16 16 16 16 16 16 16 23 16 16 16 16 16
16 16 16 16 16 16 16 11 16 16 11 16 9 16 10 10 10 10 10 10 9 10 10 10 10 10 10 10 9 10 10 10 10 10 10 10 9 10 10 10 10 10 10 10 9 10 10 10 10 16
16 16 16 16 16 10 10 9 10 10 9 10 11 16 16 16 16 16 16 16 11 16 16 16 16 16 16 16 11 16 16 16 16 16 16 16 11 16 16 16 16 16 16 16 23 16 16 16 16 16
16 16 16 16 16 16 16 11 16 16 16 16 11 16 16 16 16 16 16 16 11 16 16 16 16 16 16 16 11 16 16 16 16 16 16 16 11 16 16 16 16 16 16 16 23 16 16 16 16 16
16 16 16 16 16 16 16 11 16 16 16 16 11 16 16 16 16 16 16 16 11 16 16 16 16 16 16 16 11 16 16 16 16 16 16 16 11 16 16 16 16 16 16 16 23 16 16 16 16 16
16 10 10 10 10 10 10 9 10 10 9 10 9 16 10 10 10 10 10 10 9 10 10 9 10 10 10 10 9 10 10 10 10 10 10 10 9 10 10 10 10 10 10 10 9 10 10 10 10 16
16 16 16 16 16 16 16 16 16 16 16 16 11 16 16 16 16 16 16 16 11 16 16 11 16 16 16 16 11 16 16 16 16 16 16 16 11 16 16 16 16 16 16 16 23 16 16 16 16 16
16 16 16 16 16 16 16 16 16 16 16 16 11 16 16 16 16 16 16 16 11 16 16 11 16 16 16 16 11 16 16 16 16 16 16 16 11 16 16 16 16 16 16 16 23 16 16 16 16 16
16 16 16 16 16 16 16 16 16 16 16 16 11 16 16 16 16 16 16 16 11 16 16 11 16 16 16 16 11 16 16 16 16 16 16 16 11 16 16 16 16 16 16 16 23 16 16 16 16 16
16 10 10 10 10 10 10 10 9 10 10 10 11 10 10 10 10 10 9 10 9 10 10 9 10 10 9 10 9 10 10 10 10 10 9 10 9 10 10 10 10 10 9 10 9 10 10 10 10 16
16 16 16 16 16 16 16 16 24 16 16 16 11 16 16 16 16 16 11 16 16 16 16 16 16 16 11 16 16 16 16 16 16 16 11 16 16 16 16 16 16 16 11 16 16 16 16 16 16 16
16 16 16 16 16 16 16 16 24 16 16 16 11 16 16 16 16 16 11 16 16 16 16 16 16 16 11 16 16 16 16 16 16 16 11 16 16 16 16 16 16 16 11 16 16 16 16 16 16 16
16 16 16 16 16 16 16 16 24 16 16 16 11 16 16 16 16 16 11 16 16 16 16 16 16 16 11 16 16 16 16 16 16 16 11 16 16 16 16 16 16 16 11 16 16 16 16 16 16 16
16 16 16 16 16 16 16 16 24 16 16 16 11 16 16 16 16 16 11 16 16 16 16 16 16 16 11 16 16 16 16 16 16 16 11 16 16 16 16 16 16 16 11 16 16 16 16 16 16 16
16 16 16 16 16 16 16 16 24 16 16 16 11 16 16 16 16 16 11 16 16 16 16 16 16 16 11 16 16 16 16 16 16 16 11 16 16 16 16 16 16 16 11 16 16 16 16 16 16 16
16 10 10 10 10 10 10 10 9 10 10 10 9 10 10 10 10 10 9 10 10 10 10 10 10 10 9 10 10 10 10 10 10 10 9 10 10 10 10 10 10 10 9 10 10 10 10 10 10 16
16 16 16 16 16 16 16 16 23 16 16 16 11 16 16 16 16 16 11 16 16 16 16 16 16 16 11 16 16 16 16 16 16 16 11 16 16 16 16 16 16 16 11 16 16 16 16 16 16 16
16 16 16 16 16 16 16 16 23 16 16 16 11 16 16 16 16 16 11 16 16 16 16 16 16 16 11 16 16 16 16 16 16 16 11 16 16 16 16 16 16 16 11 16 16 16 16 16 16 16
16 16 16 16 16 16 16 16 23 16 16 16 11 16 16 16 16 16 11 16 16 16 16 16 16 16 11 16 16 16 16 16 16 16 11 16 16 16 16 16 16 16 11 16 16 16 16 16 16 16
16 16 16 16 16 16 16 16 23 16 16 16 11 16 16 16 16 16 11 16 16 16 16 16 16 16 11 16 16 16 16 16 16 16 11 16 16 16 16 16 16 16 11 16 16 16 16 16 16 16
16 16 16 16 16 16 16 16 23 16 16 16 11 16 16 16 16 16 11 16 16 16 16 16 16 16 11 16 16 16 16 16 16 16 11 16 16 16 16 16 16 16 11 16 16 16 16 16 16 16
16 10 10 10 10 10 10 10 9 10 10 10 9 10 10 10 10 10 9 10 10 10 10 10 10 10 9 10 10 10 10 10 10 10 9 10 10 10 10 10 10 10 9 10 10 10 10 10 10 16
16 16 16 16 16 16 16 16 11 16 16 16 11 16 16 16 16 16 11 16 16 16 16 16 16 16 11 16 16 16 16 16 16 16 11 16 16 16 16 16 16 16 11 16 16 16 16 16 16 16
16 16 16 16 16 16 16 16 11 16 16 16 11 16 16 16 16 16 11 16 16 16 16 16 16 16 11 16 16 16 16 16 16 16 11 16 16 16 16 16 16 16 11 16 16 16 16 16 16 16
16 16 16 16 16 16 16 16 11 16 16 16 11 16 16 16 16 16 11 16 16 16 16 16 16 16 11 16 16 16 16 16 16 16 11 16 16 16 16 16 16 16 11 16 16 16 16 16 16 16
16 16 16 16 16 16 16 16 11 16 16 16 11 16 16 16 16 16 11 16 16 16 16 16 16 16 11 16 16 16 16 16 16 16 11 16 16 16 16 16 16 16 11 16 16 16 16 16 16 16
16 16 16 16 16 16 16 16 11 16 16 16 11 16 16 16 16 16 11 16 16 16 16 16 16 16 11 16 16 16 16 16 16 16 11 16 16 16 16 16 16 16 11 16 16 16 16 16 16 16
16 10 10 10 10 10 10 10 9 10 10 10 9 10 10 10 10 10 9 10 10 10 10 10 10 10 9 10 10 10 10 10 10 10 9 10 10 10 10 10 10 10 9 10 10 10 10 10 10 16
16 16 16 16 16 16 16 16 11 16 16 16 11 16 16 16 16 16 11 16 16 16 16 16 16 16 11 16 16 16 16 16 16 16 11 16 16 16 16 16 16 16 11 16 16 16 16 16 16 16
16 16 16 16 16 16 16 16 11 16 16 16 11 16 16 16 16 16 11 16 16 16 16 16 16 16 11 16 16 16 16 16 16 16 11 16 16 16 16 16 16 16 11 16 16 16 16 16 16 16
16 16 16 16 16 16 16 16 11 16 16 16 11 16 16 16 16 16 11 16 16 16 16 16 16 16 11 16 16 16 16 16 16 16 11 16 16 16 16 16 16 16 11 16 16 16 16 16 16 16
16 16 16 16 16 16 16 16 11 16 16 16 11 16 16 16 16 16 11 16 16 16 16 16 16 16 11 16 16 16 16 16 16 16 11 16 16 16 16 16 16 16 11 16 16 16 16 16 16 16
16 16 16 16 16 16 16 16 11 16 16 16 11 16 16 16 16 16 11 16 16 16 16 16 16 16 11 16 16 16 16 16 16 16 11 16 16 16 16 16 16 16 11 16 16 16 16 16 16 16
16 16 16 16 16 16 16 16 11 16 16 16 11 16 16 16 16 16 11 16 16 16 16 16 16 16 11 16 16 16 16 16 16 16 11 16 16 16 16 16 16 16 11 16 16 16 16 16 16 16
16 16 16 16 16 16 16 16 16 16 16 16 16 16 16 16 16 16 16 16 16 16 16 16 16 16 16 16 16 16 16 16 16 16 16 16 16 16 16 16 16 16 16 16 16 16 16 16 16 16